10 20 0 16 9 16
9 14 13 13 13 9 8 8 14 9 12 15 13 11 10 8 10 8 12 13 
7 13 1 6 3 2 4 1 10 0 4 11 0 8 12 1 8 0 0 4 
11 2 2 12 9 12 1 4 9 0 0 8 0 6 5 7 7 3 4 5 
15 11 14 5 5 7 1 2 4 1 2 0 6 11 2 12 11 8 0 4 
13 9 12 3 2 10 0 12 5 7 9 0 8 14 15 3 10 0 0 4 
3 4 7 9 12 9 4 1 4 11 4 1 6 9 8 8 8 6 5 5 
11 0 12 5 5 5 1 4 3 8 0 0 10 0 0 4 5 11 0 6 
15 1 0 0 0 0 6 1 8 0 0 0 8 0 2 2 0 8 0 12 
11 0 0 6 1 4 9 4 3 0 0 4 5 7 9 12 5 1 2 4 
15 3 6 11 2 2 2 2 10 2 2 2 2 10 2 2 6 7 11 6 
